,Geography,Geographic Area Name,Families with No workers in past year,Families receiving food stamps/SNAP with No workers in past year,Gap,County,State
0,0500000US01003,"Baldwin County, Alabama",13808,685,13123,Baldwin County, Alabama
1,0500000US01015,"Calhoun County, Alabama",6229,1603,4626,Calhoun County, Alabama
2,0500000US01055,"Etowah County, Alabama",5329,688,4641,Etowah County, Alabama
3,0500000US01069,"Houston County, Alabama",5966,1459,4507,Houston County, Alabama
4,0500000US01073,"Jefferson County, Alabama",25249,6848,18401,Jefferson County, Alabama
5,0500000US01077,"Lauderdale County, Alabama",5171,945,4226,Lauderdale County, Alabama
6,0500000US01081,"Lee County, Alabama",6246,781,5465,Lee County, Alabama
7,0500000US01089,"Madison County, Alabama",14442,1541,12901,Madison County, Alabama
8,0500000US01095,"Marshall County, Alabama",5864,1548,4316,Marshall County, Alabama
9,0500000US01097,"Mobile County, Alabama",18547,5096,13451,Mobile County, Alabama
10,0500000US01101,"Montgomery County, Alabama",10143,2763,7380,Montgomery County, Alabama
11,0500000US01103,"Morgan County, Alabama",6474,1144,5330,Morgan County, Alabama
12,0500000US01117,"Shelby County, Alabama",6950,395,6555,Shelby County, Alabama
13,0500000US01121,"Talladega County, Alabama",5971,1967,4004,Talladega County, Alabama
14,0500000US01125,"Tuscaloosa County, Alabama",9200,1431,7769,Tuscaloosa County, Alabama
15,0500000US02020,"Anchorage Municipality, Alaska",6584,1470,5114,Anchorage Municipality, Alaska
16,0500000US02170,"Matanuska-Susitna Borough, Alaska",4500,374,4126,Matanuska-Susitna Borough, Alaska
17,0500000US04001,"Apache County, Arizona",4445,1740,2705,Apache County, Arizona
18,0500000US04003,"Cochise County, Arizona",7636,1062,6574,Cochise County, Arizona
19,0500000US04005,"Coconino County, Arizona",4946,884,4062,Coconino County, Arizona
20,0500000US04013,"Maricopa County, Arizona",175272,20765,154507,Maricopa County, Arizona
21,0500000US04015,"Mohave County, Arizona",24012,2636,21376,Mohave County, Arizona
22,0500000US04017,"Navajo County, Arizona",7873,1837,6036,Navajo County, Arizona
23,0500000US04019,"Pima County, Arizona",52775,7931,44844,Pima County, Arizona
24,0500000US04021,"Pinal County, Arizona",27438,2963,24475,Pinal County, Arizona
25,0500000US04025,"Yavapai County, Arizona",22737,803,21934,Yavapai County, Arizona
26,0500000US04027,"Yuma County, Arizona",12043,2597,9446,Yuma County, Arizona
27,0500000US05007,"Benton County, Arkansas",11574,1373,10201,Benton County, Arkansas
28,0500000US05119,"Pulaski County, Arkansas",16948,2372,14576,Pulaski County, Arkansas
29,0500000US05131,"Sebastian County, Arkansas",6407,1416,4991,Sebastian County, Arkansas
30,0500000US05143,"Washington County, Arkansas",7148,1010,6138,Washington County, Arkansas
31,0500000US06001,"Alameda County, California",42136,7089,35047,Alameda County, California
32,0500000US06007,"Butte County, California",10751,1734,9017,Butte County, California
33,0500000US06013,"Contra Costa County, California",38479,4278,34201,Contra Costa County, California
34,0500000US06017,"El Dorado County, California",9898,158,9740,El Dorado County, California
35,0500000US06019,"Fresno County, California",33772,10356,23416,Fresno County, California
36,0500000US06023,"Humboldt County, California",6314,975,5339,Humboldt County, California
37,0500000US06025,"Imperial County, California",6303,2380,3923,Imperial County, California
38,0500000US06029,"Kern County, California",33551,11119,22432,Kern County, California
39,0500000US06031,"Kings County, California",5162,1349,3813,Kings County, California
40,0500000US06037,"Los Angeles County, California",274819,65053,209766,Los Angeles County, California
41,0500000US06039,"Madera County, California",5964,1685,4279,Madera County, California
42,0500000US06041,"Marin County, California",9123,791,8332,Marin County, California
43,0500000US06047,"Merced County, California",12220,4173,8047,Merced County, California
44,0500000US06053,"Monterey County, California",13280,1032,12248,Monterey County, California
45,0500000US06055,"Napa County, California",5149,260,4889,Napa County, California
46,0500000US06059,"Orange County, California",95965,9449,86516,Orange County, California
47,0500000US06061,"Placer County, California",21267,1078,20189,Placer County, California
48,0500000US06065,"Riverside County, California",89441,13372,76069,Riverside County, California
49,0500000US06067,"Sacramento County, California",53756,11179,42577,Sacramento County, California
50,0500000US06071,"San Bernardino County, California",69507,15737,53770,San Bernardino County, California
51,0500000US06073,"San Diego County, California",105881,14849,91032,San Diego County, California
52,0500000US06075,"San Francisco County, California",23295,5181,18114,San Francisco County, California
53,0500000US06077,"San Joaquin County, California",23394,6052,17342,San Joaquin County, California
54,0500000US06079,"San Luis Obispo County, California",13849,230,13619,San Luis Obispo County, California
55,0500000US06081,"San Mateo County, California",21052,980,20072,San Mateo County, California
56,0500000US06083,"Santa Barbara County, California",14557,1833,12724,Santa Barbara County, California
57,0500000US06085,"Santa Clara County, California",48659,4763,43896,Santa Clara County, California
58,0500000US06087,"Santa Cruz County, California",9392,596,8796,Santa Cruz County, California
59,0500000US06089,"Shasta County, California",10630,1572,9058,Shasta County, California
60,0500000US06095,"Solano County, California",15024,2303,12721,Solano County, California
61,0500000US06097,"Sonoma County, California",18208,1608,16600,Sonoma County, California
62,0500000US06099,"Stanislaus County, California",16593,4897,11696,Stanislaus County, California
63,0500000US06101,"Sutter County, California",3746,601,3145,Sutter County, California
64,0500000US06107,"Tulare County, California",15894,5519,10375,Tulare County, California
65,0500000US06111,"Ventura County, California",28397,2448,25949,Ventura County, California
66,0500000US06113,"Yolo County, California",5958,922,5036,Yolo County, California
67,0500000US06115,"Yuba County, California",3639,918,2721,Yuba County, California
68,0500000US08001,"Adams County, Colorado",10674,963,9711,Adams County, Colorado
69,0500000US08005,"Arapahoe County, Colorado",16128,2080,14048,Arapahoe County, Colorado
70,0500000US08013,"Boulder County, Colorado",10532,654,9878,Boulder County, Colorado
71,0500000US08031,"Denver County, Colorado",16705,2844,13861,Denver County, Colorado
72,0500000US08035,"Douglas County, Colorado",10892,110,10782,Douglas County, Colorado
73,0500000US08041,"El Paso County, Colorado",23760,2749,21011,El Paso County, Colorado
74,0500000US08059,"Jefferson County, Colorado",21850,1000,20850,Jefferson County, Colorado
75,0500000US08069,"Larimer County, Colorado",14837,648,14189,Larimer County, Colorado
76,0500000US08077,"Mesa County, Colorado",7511,958,6553,Mesa County, Colorado
77,0500000US08101,"Pueblo County, Colorado",9106,2404,6702,Pueblo County, Colorado
78,0500000US08123,"Weld County, Colorado",10543,1369,9174,Weld County, Colorado
79,0500000US09001,"Fairfield County, Connecticut",26866,3935,22931,Fairfield County, Connecticut
80,0500000US09003,"Hartford County, Connecticut",31673,6001,25672,Hartford County, Connecticut
81,0500000US09005,"Litchfield County, Connecticut",8518,1301,7217,Litchfield County, Connecticut
82,0500000US09009,"New Haven County, Connecticut",30126,7301,22825,New Haven County, Connecticut
83,0500000US09011,"New London County, Connecticut",11882,1825,10057,New London County, Connecticut
84,0500000US09015,"Windham County, Connecticut",5498,1266,4232,Windham County, Connecticut
85,0500000US10001,"Kent County, Delaware",8763,1035,7728,Kent County, Delaware
86,0500000US10003,"New Castle County, Delaware",19962,2910,17052,New Castle County, Delaware
87,0500000US10005,"Sussex County, Delaware",21944,1458,20486,Sussex County, Delaware
88,0500000US11001,"District of Columbia, District of Columbia",18723,8584,10139,District of Columbia, District of Columbia
89,0500000US12001,"Alachua County, Florida",8057,669,7388,Alachua County, Florida
90,0500000US12005,"Bay County, Florida",7888,1053,6835,Bay County, Florida
91,0500000US12009,"Brevard County, Florida",35205,2923,32282,Brevard County, Florida
92,0500000US12011,"Broward County, Florida",61404,12847,48557,Broward County, Florida
93,0500000US12015,"Charlotte County, Florida",21951,1287,20664,Charlotte County, Florida
94,0500000US12017,"Citrus County, Florida",18954,1851,17103,Citrus County, Florida
95,0500000US12019,"Clay County, Florida",9336,957,8379,Clay County, Florida
96,0500000US12021,"Collier County, Florida",33644,637,33007,Collier County, Florida
97,0500000US12031,"Duval County, Florida",34257,7820,26437,Duval County, Florida
98,0500000US12033,"Escambia County, Florida",15053,3499,11554,Escambia County, Florida
99,0500000US12035,"Flagler County, Florida",12669,958,11711,Flagler County, Florida
100,0500000US12053,"Hernando County, Florida",14710,1934,12776,Hernando County, Florida
101,0500000US12057,"Hillsborough County, Florida",53888,12346,41542,Hillsborough County, Florida
102,0500000US12069,"Lake County, Florida",29615,2667,26948,Lake County, Florida
103,0500000US12071,"Lee County, Florida",61476,4680,56796,Lee County, Florida
104,0500000US12073,"Leon County, Florida",8669,1038,7631,Leon County, Florida
105,0500000US12081,"Manatee County, Florida",28979,1244,27735,Manatee County, Florida
106,0500000US12083,"Marion County, Florida",29670,3017,26653,Marion County, Florida
107,0500000US12086,"Miami-Dade County, Florida",80339,31787,48552,Miami-Dade County, Florida
108,0500000US12091,"Okaloosa County, Florida",8778,1723,7055,Okaloosa County, Florida
109,0500000US12095,"Orange County, Florida",46701,10748,35953,Orange County, Florida
110,0500000US12097,"Osceola County, Florida",14866,3626,11240,Osceola County, Florida
111,0500000US12099,"Palm Beach County, Florida",72830,5930,66900,Palm Beach County, Florida
112,0500000US12101,"Pasco County, Florida",32179,4270,27909,Pasco County, Florida
113,0500000US12103,"Pinellas County, Florida",50864,4675,46189,Pinellas County, Florida
114,0500000US12105,"Polk County, Florida",41078,7889,33189,Polk County, Florida
115,0500000US12109,"St. Johns County, Florida",14572,406,14166,St. Johns County, Florida
116,0500000US12111,"St. Lucie County, Florida",18596,2354,16242,St. Lucie County, Florida
117,0500000US12113,"Santa Rosa County, Florida",8753,691,8062,Santa Rosa County, Florida
118,0500000US12115,"Sarasota County, Florida",41421,1408,40013,Sarasota County, Florida
119,0500000US12117,"Seminole County, Florida",16857,1868,14989,Seminole County, Florida
120,0500000US12127,"Volusia County, Florida",37654,4459,33195,Volusia County, Florida
121,0500000US13013,"Barrow County, Georgia",2717,575,2142,Barrow County, Georgia
122,0500000US13021,"Bibb County, Georgia",6604,2656,3948,Bibb County, Georgia
123,0500000US13045,"Carroll County, Georgia",3286,724,2562,Carroll County, Georgia
124,0500000US13051,"Chatham County, Georgia",13090,2328,10762,Chatham County, Georgia
125,0500000US13057,"Cherokee County, Georgia",8538,248,8290,Cherokee County, Georgia
126,0500000US13063,"Clayton County, Georgia",9507,3735,5772,Clayton County, Georgia
127,0500000US13067,"Cobb County, Georgia",19608,1811,17797,Cobb County, Georgia
128,0500000US13089,"DeKalb County, Georgia",17646,2966,14680,DeKalb County, Georgia
129,0500000US13095,"Dougherty County, Georgia",3537,1197,2340,Dougherty County, Georgia
130,0500000US13117,"Forsyth County, Georgia",7089,811,6278,Forsyth County, Georgia
131,0500000US13121,"Fulton County, Georgia",26508,5701,20807,Fulton County, Georgia
132,0500000US13135,"Gwinnett County, Georgia",24340,4302,20038,Gwinnett County, Georgia
133,0500000US13139,"Hall County, Georgia",7236,824,6412,Hall County, Georgia
134,0500000US13151,"Henry County, Georgia",7497,1369,6128,Henry County, Georgia
135,0500000US13153,"Houston County, Georgia",7120,1704,5416,Houston County, Georgia
136,0500000US13179,"Liberty County, Georgia",3467,908,2559,Liberty County, Georgia
137,0500000US13215,"Muscogee County, Georgia",8858,2522,6336,Muscogee County, Georgia
138,0500000US13223,"Paulding County, Georgia",7385,1356,6029,Paulding County, Georgia
139,0500000US13245,"Richmond County, Georgia",8091,3300,4791,Richmond County, Georgia
140,0500000US13297,"Walton County, Georgia",4483,1366,3117,Walton County, Georgia
141,0500000US13313,"Whitfield County, Georgia",3199,462,2737,Whitfield County, Georgia
142,0500000US15001,"Hawaii County, Hawaii",10606,1760,8846,Hawaii County, Hawaii
143,0500000US15003,"Honolulu County, Hawaii",30467,5666,24801,Honolulu County, Hawaii
144,0500000US15007,"Kauai County, Hawaii",3116,287,2829,Kauai County, Hawaii
145,0500000US15009,"Maui County, Hawaii",5893,774,5119,Maui County, Hawaii
146,0500000US16001,"Ada County, Idaho",17047,1399,15648,Ada County, Idaho
147,0500000US16005,"Bannock County, Idaho",3130,826,2304,Bannock County, Idaho
148,0500000US16019,"Bonneville County, Idaho",4543,584,3959,Bonneville County, Idaho
149,0500000US16027,"Canyon County, Idaho",8480,308,8172,Canyon County, Idaho
150,0500000US17019,"Champaign County, Illinois",6142,495,5647,Champaign County, Illinois
151,0500000US17031,"Cook County, Illinois",161261,45325,115936,Cook County, Illinois
152,0500000US17037,"DeKalb County, Illinois",4280,531,3749,DeKalb County, Illinois
153,0500000US17043,"DuPage County, Illinois",29485,2927,26558,DuPage County, Illinois
154,0500000US17089,"Kane County, Illinois",13267,1397,11870,Kane County, Illinois
155,0500000US17091,"Kankakee County, Illinois",5172,800,4372,Kankakee County, Illinois
156,0500000US17097,"Lake County, Illinois",19762,3021,16741,Lake County, Illinois
157,0500000US17099,"LaSalle County, Illinois",5082,785,4297,LaSalle County, Illinois
158,0500000US17111,"McHenry County, Illinois",9493,399,9094,McHenry County, Illinois
159,0500000US17113,"McLean County, Illinois",6024,844,5180,McLean County, Illinois
160,0500000US17115,"Macon County, Illinois",5765,1446,4319,Macon County, Illinois
161,0500000US17119,"Madison County, Illinois",11268,1689,9579,Madison County, Illinois
162,0500000US17143,"Peoria County, Illinois",9025,1862,7163,Peoria County, Illinois
163,0500000US17161,"Rock Island County, Illinois",7190,1481,5709,Rock Island County, Illinois
164,0500000US17163,"St. Clair County, Illinois",10002,2102,7900,St. Clair County, Illinois
165,0500000US17167,"Sangamon County, Illinois",9024,1752,7272,Sangamon County, Illinois
166,0500000US17179,"Tazewell County, Illinois",7213,657,6556,Tazewell County, Illinois
167,0500000US17183,"Vermilion County, Illinois",3551,705,2846,Vermilion County, Illinois
168,0500000US17197,"Will County, Illinois",20712,2294,18418,Will County, Illinois
169,0500000US17199,"Williamson County, Illinois",4529,1283,3246,Williamson County, Illinois
170,0500000US17201,"Winnebago County, Illinois",13519,3021,10498,Winnebago County, Illinois
171,0500000US18003,"Allen County, Indiana",13277,1657,11620,Allen County, Indiana
172,0500000US18019,"Clark County, Indiana",5092,713,4379,Clark County, Indiana
173,0500000US18035,"Delaware County, Indiana",4633,1069,3564,Delaware County, Indiana
174,0500000US18039,"Elkhart County, Indiana",6801,767,6034,Elkhart County, Indiana
175,0500000US18057,"Hamilton County, Indiana",8101,102,7999,Hamilton County, Indiana
176,0500000US18067,"Howard County, Indiana",4752,867,3885,Howard County, Indiana
177,0500000US18089,"Lake County, Indiana",23462,5753,17709,Lake County, Indiana
178,0500000US18095,"Madison County, Indiana",6090,1112,4978,Madison County, Indiana
179,0500000US18097,"Marion County, Indiana",29287,6282,23005,Marion County, Indiana
180,0500000US18127,"Porter County, Indiana",8210,519,7691,Porter County, Indiana
181,0500000US18141,"St. Joseph County, Indiana",10393,1885,8508,St. Joseph County, Indiana
182,0500000US18157,"Tippecanoe County, Indiana",5370,924,4446,Tippecanoe County, Indiana
183,0500000US18163,"Vanderburgh County, Indiana",5638,1104,4534,Vanderburgh County, Indiana
184,0500000US18167,"Vigo County, Indiana",4617,864,3753,Vigo County, Indiana
185,0500000US19013,"Black Hawk County, Iowa",5294,326,4968,Black Hawk County, Iowa
186,0500000US19061,"Dubuque County, Iowa",3742,206,3536,Dubuque County, Iowa
187,0500000US19113,"Linn County, Iowa",9241,1275,7966,Linn County, Iowa
188,0500000US19153,"Polk County, Iowa",15643,1476,14167,Polk County, Iowa
189,0500000US19155,"Pottawattamie County, Iowa",4172,704,3468,Pottawattamie County, Iowa
190,0500000US19163,"Scott County, Iowa",7448,1503,5945,Scott County, Iowa
191,0500000US19193,"Woodbury County, Iowa",4039,907,3132,Woodbury County, Iowa
192,0500000US20091,"Johnson County, Kansas",20251,702,19549,Johnson County, Kansas
193,0500000US20173,"Sedgwick County, Kansas",18186,2238,15948,Sedgwick County, Kansas
194,0500000US20177,"Shawnee County, Kansas",8779,780,7999,Shawnee County, Kansas
195,0500000US20209,"Wyandotte County, Kansas",4971,970,4001,Wyandotte County, Kansas
196,0500000US21037,"Campbell County, Kentucky",3290,535,2755,Campbell County, Kentucky
197,0500000US21059,"Daviess County, Kentucky",4793,727,4066,Daviess County, Kentucky
198,0500000US21067,"Fayette County, Kentucky",10253,1557,8696,Fayette County, Kentucky
199,0500000US21093,"Hardin County, Kentucky",4942,306,4636,Hardin County, Kentucky
200,0500000US21111,"Jefferson County, Kentucky",29136,4625,24511,Jefferson County, Kentucky
201,0500000US21117,"Kenton County, Kentucky",7317,807,6510,Kenton County, Kentucky
202,0500000US21151,"Madison County, Kentucky",4052,447,3605,Madison County, Kentucky
203,0500000US21227,"Warren County, Kentucky",4829,1450,3379,Warren County, Kentucky
204,0500000US22017,"Caddo Parish, Louisiana",13514,4794,8720,Caddo Parish, Louisiana
205,0500000US22019,"Calcasieu Parish, Louisiana",8792,1807,6985,Calcasieu Parish, Louisiana
206,0500000US22033,"East Baton Rouge Parish, Louisiana",18249,4096,14153,East Baton Rouge Parish, Louisiana
207,0500000US22051,"Jefferson Parish, Louisiana",19816,3751,16065,Jefferson Parish, Louisiana
208,0500000US22055,"Lafayette Parish, Louisiana",10837,2971,7866,Lafayette Parish, Louisiana
209,0500000US22057,"Lafourche Parish, Louisiana",4470,1044,3426,Lafourche Parish, Louisiana
210,0500000US22063,"Livingston Parish, Louisiana",5558,999,4559,Livingston Parish, Louisiana
211,0500000US22071,"Orleans Parish, Louisiana",12506,4200,8306,Orleans Parish, Louisiana
212,0500000US22073,"Ouachita Parish, Louisiana",8613,2869,5744,Ouachita Parish, Louisiana
213,0500000US22079,"Rapides Parish, Louisiana",5726,1509,4217,Rapides Parish, Louisiana
214,0500000US22097,"St. Landry Parish, Louisiana",4895,1799,3096,St. Landry Parish, Louisiana
215,0500000US22103,"St. Tammany Parish, Louisiana",12457,1180,11277,St. Tammany Parish, Louisiana
216,0500000US22105,"Tangipahoa Parish, Louisiana",6377,1806,4571,Tangipahoa Parish, Louisiana
217,0500000US23001,"Androscoggin County, Maine",4090,828,3262,Androscoggin County, Maine
218,0500000US23003,"Aroostook County, Maine",4808,885,3923,Aroostook County, Maine
219,0500000US23005,"Cumberland County, Maine",10628,648,9980,Cumberland County, Maine
220,0500000US23011,"Kennebec County, Maine",7214,1830,5384,Kennebec County, Maine
221,0500000US23019,"Penobscot County, Maine",7628,1073,6555,Penobscot County, Maine
222,0500000US23031,"York County, Maine",9928,1359,8569,York County, Maine
223,0500000US24001,"Allegany County, Maryland",3272,653,2619,Allegany County, Maryland
224,0500000US24003,"Anne Arundel County, Maryland",20014,2032,17982,Anne Arundel County, Maryland
225,0500000US24005,"Baltimore County, Maryland",28992,5591,23401,Baltimore County, Maryland
226,0500000US24013,"Carroll County, Maryland",5737,215,5522,Carroll County, Maryland
227,0500000US24015,"Cecil County, Maryland",5033,959,4074,Cecil County, Maryland
228,0500000US24017,"Charles County, Maryland",4876,898,3978,Charles County, Maryland
229,0500000US24021,"Frederick County, Maryland",8293,1540,6753,Frederick County, Maryland
230,0500000US24025,"Harford County, Maryland",9626,995,8631,Harford County, Maryland
231,0500000US24027,"Howard County, Maryland",10100,1171,8929,Howard County, Maryland
232,0500000US24031,"Montgomery County, Maryland",27555,3600,23955,Montgomery County, Maryland
233,0500000US24033,"Prince George's County, Maryland",23267,2997,20270,Prince George's County, Maryland
234,0500000US24043,"Washington County, Maryland",7676,2226,5450,Washington County, Maryland
235,0500000US24045,"Wicomico County, Maryland",2909,831,2078,Wicomico County, Maryland
236,0500000US24510,"Baltimore city, Maryland",19519,9408,10111,Baltimore city, Maryland
237,0500000US25001,"Barnstable County, Massachusetts",13876,887,12989,Barnstable County, Massachusetts
238,0500000US25003,"Berkshire County, Massachusetts",6147,874,5273,Berkshire County, Massachusetts
239,0500000US25005,"Bristol County, Massachusetts",21675,6615,15060,Bristol County, Massachusetts
240,0500000US25009,"Essex County, Massachusetts",25867,5553,20314,Essex County, Massachusetts
241,0500000US25011,"Franklin County, Massachusetts",3449,443,3006,Franklin County, Massachusetts
242,0500000US25013,"Hampden County, Massachusetts",22166,9232,12934,Hampden County, Massachusetts
243,0500000US25015,"Hampshire County, Massachusetts",5893,647,5246,Hampshire County, Massachusetts
244,0500000US25017,"Middlesex County, Massachusetts",41429,8128,33301,Middlesex County, Massachusetts
245,0500000US25021,"Norfolk County, Massachusetts",20835,3255,17580,Norfolk County, Massachusetts
246,0500000US25023,"Plymouth County, Massachusetts",18947,3173,15774,Plymouth County, Massachusetts
247,0500000US25025,"Suffolk County, Massachusetts",17060,7645,9415,Suffolk County, Massachusetts
248,0500000US25027,"Worcester County, Massachusetts",27258,6826,20432,Worcester County, Massachusetts
249,0500000US26005,"Allegan County, Michigan",5173,203,4970,Allegan County, Michigan
250,0500000US26017,"Bay County, Michigan",5380,554,4826,Bay County, Michigan
251,0500000US26021,"Berrien County, Michigan",8596,1520,7076,Berrien County, Michigan
252,0500000US26025,"Calhoun County, Michigan",6542,987,5555,Calhoun County, Michigan
253,0500000US26045,"Eaton County, Michigan",4660,908,3752,Eaton County, Michigan
254,0500000US26049,"Genesee County, Michigan",23310,5946,17364,Genesee County, Michigan
255,0500000US26065,"Ingham County, Michigan",10364,2112,8252,Ingham County, Michigan
256,0500000US26075,"Jackson County, Michigan",6956,966,5990,Jackson County, Michigan
257,0500000US26077,"Kalamazoo County, Michigan",9635,1560,8075,Kalamazoo County, Michigan
258,0500000US26081,"Kent County, Michigan",21328,2463,18865,Kent County, Michigan
259,0500000US26087,"Lapeer County, Michigan",5090,433,4657,Lapeer County, Michigan
260,0500000US26091,"Lenawee County, Michigan",4658,941,3717,Lenawee County, Michigan
261,0500000US26093,"Livingston County, Michigan",8873,623,8250,Livingston County, Michigan
262,0500000US26099,"Macomb County, Michigan",35825,6112,29713,Macomb County, Michigan
263,0500000US26111,"Midland County, Michigan",4790,289,4501,Midland County, Michigan
264,0500000US26115,"Monroe County, Michigan",8674,1175,7499,Monroe County, Michigan
265,0500000US26117,"Montcalm County, Michigan",3387,522,2865,Montcalm County, Michigan
266,0500000US26121,"Muskegon County, Michigan",9769,1731,8038,Muskegon County, Michigan
267,0500000US26125,"Oakland County, Michigan",49194,7710,41484,Oakland County, Michigan
268,0500000US26139,"Ottawa County, Michigan",12811,1395,11416,Ottawa County, Michigan
269,0500000US26145,"Saginaw County, Michigan",11786,3327,8459,Saginaw County, Michigan
270,0500000US26147,"St. Clair County, Michigan",9065,1370,7695,St. Clair County, Michigan
271,0500000US26155,"Shiawassee County, Michigan",3552,886,2666,Shiawassee County, Michigan
272,0500000US26159,"Van Buren County, Michigan",3936,546,3390,Van Buren County, Michigan
273,0500000US26161,"Washtenaw County, Michigan",11394,1098,10296,Washtenaw County, Michigan
274,0500000US26163,"Wayne County, Michigan",78472,24741,53731,Wayne County, Michigan
275,0500000US27003,"Anoka County, Minnesota",12000,958,11042,Anoka County, Minnesota
276,0500000US27035,"Crow Wing County, Minnesota",4000,239,3761,Crow Wing County, Minnesota
277,0500000US27037,"Dakota County, Minnesota",13793,1029,12764,Dakota County, Minnesota
278,0500000US27053,"Hennepin County, Minnesota",33089,3387,29702,Hennepin County, Minnesota
279,0500000US27123,"Ramsey County, Minnesota",16928,2847,14081,Ramsey County, Minnesota
280,0500000US27137,"St. Louis County, Minnesota",10094,1053,9041,St. Louis County, Minnesota
281,0500000US27145,"Stearns County, Minnesota",4909,158,4751,Stearns County, Minnesota
282,0500000US27163,"Washington County, Minnesota",11456,593,10863,Washington County, Minnesota
283,0500000US28033,"DeSoto County, Mississippi",5269,352,4917,DeSoto County, Mississippi
284,0500000US28047,"Harrison County, Mississippi",10133,1952,8181,Harrison County, Mississippi
285,0500000US28049,"Hinds County, Mississippi",8309,1826,6483,Hinds County, Mississippi
286,0500000US29021,"Buchanan County, Missouri",2803,133,2670,Buchanan County, Missouri
287,0500000US29047,"Clay County, Missouri",7673,805,6868,Clay County, Missouri
288,0500000US29077,"Greene County, Missouri",13565,2187,11378,Greene County, Missouri
289,0500000US29095,"Jackson County, Missouri",24412,3042,21370,Jackson County, Missouri
290,0500000US29097,"Jasper County, Missouri",4447,536,3911,Jasper County, Missouri
291,0500000US29099,"Jefferson County, Missouri",8963,830,8133,Jefferson County, Missouri
292,0500000US29183,"St. Charles County, Missouri",14022,545,13477,St. Charles County, Missouri
293,0500000US29189,"St. Louis County, Missouri",36956,4750,32206,St. Louis County, Missouri
294,0500000US29510,"St. Louis city, Missouri",9471,3560,5911,St. Louis city, Missouri
295,0500000US30111,"Yellowstone County, Montana",8986,635,8351,Yellowstone County, Montana
296,0500000US31055,"Douglas County, Nebraska",14967,2107,12860,Douglas County, Nebraska
297,0500000US31109,"Lancaster County, Nebraska",9583,870,8713,Lancaster County, Nebraska
298,0500000US31153,"Sarpy County, Nebraska",5313,597,4716,Sarpy County, Nebraska
299,0500000US32003,"Clark County, Nevada",89425,16865,72560,Clark County, Nevada
300,0500000US32031,"Washoe County, Nevada",16267,2816,13451,Washoe County, Nevada
301,0500000US33011,"Hillsborough County, New Hampshire",13382,1239,12143,Hillsborough County, New Hampshire
302,0500000US33013,"Merrimack County, New Hampshire",6248,657,5591,Merrimack County, New Hampshire
303,0500000US33015,"Rockingham County, New Hampshire",12536,859,11677,Rockingham County, New Hampshire
304,0500000US34001,"Atlantic County, New Jersey",10987,2917,8070,Atlantic County, New Jersey
305,0500000US34003,"Bergen County, New Jersey",26710,1571,25139,Bergen County, New Jersey
306,0500000US34005,"Burlington County, New Jersey",17375,1855,15520,Burlington County, New Jersey
307,0500000US34007,"Camden County, New Jersey",17080,3600,13480,Camden County, New Jersey
308,0500000US34011,"Cumberland County, New Jersey",6289,1602,4687,Cumberland County, New Jersey
309,0500000US34013,"Essex County, New Jersey",25063,7326,17737,Essex County, New Jersey
310,0500000US34015,"Gloucester County, New Jersey",12478,1786,10692,Gloucester County, New Jersey
311,0500000US34017,"Hudson County, New Jersey",15680,5331,10349,Hudson County, New Jersey
312,0500000US34021,"Mercer County, New Jersey",11487,1559,9928,Mercer County, New Jersey
313,0500000US34023,"Middlesex County, New Jersey",22590,1294,21296,Middlesex County, New Jersey
314,0500000US34025,"Monmouth County, New Jersey",21910,1112,20798,Monmouth County, New Jersey
315,0500000US34027,"Morris County, New Jersey",14617,789,13828,Morris County, New Jersey
316,0500000US34029,"Ocean County, New Jersey",29645,1721,27924,Ocean County, New Jersey
317,0500000US34031,"Passaic County, New Jersey",17562,5786,11776,Passaic County, New Jersey
318,0500000US34035,"Somerset County, New Jersey",9956,604,9352,Somerset County, New Jersey
319,0500000US34037,"Sussex County, New Jersey",5149,226,4923,Sussex County, New Jersey
320,0500000US34039,"Union County, New Jersey",15698,2010,13688,Union County, New Jersey
321,0500000US34041,"Warren County, New Jersey",4366,909,3457,Warren County, New Jersey
322,0500000US35001,"Bernalillo County, New Mexico",28653,6084,22569,Bernalillo County, New Mexico
323,0500000US35013,"Doña Ana County, New Mexico",12228,3635,8593,Doña Ana County, New Mexico
324,0500000US35031,"McKinley County, New Mexico",3694,1847,1847,McKinley County, New Mexico
325,0500000US35043,"Sandoval County, New Mexico",8004,894,7110,Sandoval County, New Mexico
326,0500000US35045,"San Juan County, New Mexico",7183,2976,4207,San Juan County, New Mexico
327,0500000US35049,"Santa Fe County, New Mexico",8509,413,8096,Santa Fe County, New Mexico
328,0500000US35061,"Valencia County, New Mexico",4960,1135,3825,Valencia County, New Mexico
329,0500000US36001,"Albany County, New York",12841,1668,11173,Albany County, New York
330,0500000US36005,"Bronx County, New York",56257,32496,23761,Bronx County, New York
331,0500000US36007,"Broome County, New York",7989,1966,6023,Broome County, New York
332,0500000US36009,"Cattaraugus County, New York",3626,732,2894,Cattaraugus County, New York
333,0500000US36011,"Cayuga County, New York",4358,1025,3333,Cayuga County, New York
334,0500000US36013,"Chautauqua County, New York",7124,2035,5089,Chautauqua County, New York
335,0500000US36019,"Clinton County, New York",4848,1329,3519,Clinton County, New York
336,0500000US36027,"Dutchess County, New York",11496,1122,10374,Dutchess County, New York
337,0500000US36029,"Erie County, New York",41215,10848,30367,Erie County, New York
338,0500000US36045,"Jefferson County, New York",5688,897,4791,Jefferson County, New York
339,0500000US36047,"Kings County, New York",85957,35655,50302,Kings County, New York
340,0500000US36055,"Monroe County, New York",32640,6948,25692,Monroe County, New York
341,0500000US36059,"Nassau County, New York",39662,1944,37718,Nassau County, New York
342,0500000US36061,"New York County, New York",47653,19031,28622,New York County, New York
343,0500000US36063,"Niagara County, New York",10264,1766,8498,Niagara County, New York
344,0500000US36065,"Oneida County, New York",9698,1696,8002,Oneida County, New York
345,0500000US36067,"Onondaga County, New York",19650,4329,15321,Onondaga County, New York
346,0500000US36069,"Ontario County, New York",5640,676,4964,Ontario County, New York
347,0500000US36071,"Orange County, New York",12412,2103,10309,Orange County, New York
348,0500000US36075,"Oswego County, New York",5824,1811,4013,Oswego County, New York
349,0500000US36081,"Queens County, New York",77179,18557,58622,Queens County, New York
350,0500000US36083,"Rensselaer County, New York",6829,1183,5646,Rensselaer County, New York
351,0500000US36085,"Richmond County, New York",18897,4133,14764,Richmond County, New York
352,0500000US36087,"Rockland County, New York",10061,1470,8591,Rockland County, New York
353,0500000US36089,"St. Lawrence County, New York",5573,1107,4466,St. Lawrence County, New York
354,0500000US36091,"Saratoga County, New York",10200,1459,8741,Saratoga County, New York
355,0500000US36093,"Schenectady County, New York",6592,1405,5187,Schenectady County, New York
356,0500000US36101,"Steuben County, New York",4859,802,4057,Steuben County, New York
357,0500000US36103,"Suffolk County, New York",47085,3935,43150,Suffolk County, New York
358,0500000US36111,"Ulster County, New York",7467,586,6881,Ulster County, New York
359,0500000US36117,"Wayne County, New York",4032,668,3364,Wayne County, New York
360,0500000US36119,"Westchester County, New York",32293,5482,26811,Westchester County, New York
361,0500000US37001,"Alamance County, North Carolina",7103,1116,5987,Alamance County, North Carolina
362,0500000US37019,"Brunswick County, North Carolina",15301,760,14541,Brunswick County, North Carolina
363,0500000US37021,"Buncombe County, North Carolina",12631,1329,11302,Buncombe County, North Carolina
364,0500000US37023,"Burke County, North Carolina",5453,669,4784,Burke County, North Carolina
365,0500000US37025,"Cabarrus County, North Carolina",6583,487,6096,Cabarrus County, North Carolina
366,0500000US37031,"Carteret County, North Carolina",4945,442,4503,Carteret County, North Carolina
367,0500000US37035,"Catawba County, North Carolina",8318,1684,6634,Catawba County, North Carolina
368,0500000US37045,"Cleveland County, North Carolina",5256,539,4717,Cleveland County, North Carolina
369,0500000US37049,"Craven County, North Carolina",6159,1030,5129,Craven County, North Carolina
370,0500000US37051,"Cumberland County, North Carolina",12053,3420,8633,Cumberland County, North Carolina
371,0500000US37057,"Davidson County, North Carolina",9818,2094,7724,Davidson County, North Carolina
372,0500000US37063,"Durham County, North Carolina",10796,1430,9366,Durham County, North Carolina
373,0500000US37067,"Forsyth County, North Carolina",14765,1913,12852,Forsyth County, North Carolina
374,0500000US37071,"Gaston County, North Carolina",10188,2794,7394,Gaston County, North Carolina
375,0500000US37081,"Guilford County, North Carolina",19304,3875,15429,Guilford County, North Carolina
376,0500000US37085,"Harnett County, North Carolina",5888,1104,4784,Harnett County, North Carolina
377,0500000US37089,"Henderson County, North Carolina",8623,581,8042,Henderson County, North Carolina
378,0500000US37097,"Iredell County, North Carolina",6974,833,6141,Iredell County, North Carolina
379,0500000US37101,"Johnston County, North Carolina",7244,1210,6034,Johnston County, North Carolina
380,0500000US37119,"Mecklenburg County, North Carolina",27574,3835,23739,Mecklenburg County, North Carolina
381,0500000US37129,"New Hanover County, North Carolina",10516,1223,9293,New Hanover County, North Carolina
382,0500000US37147,"Pitt County, North Carolina",7317,1909,5408,Pitt County, North Carolina
383,0500000US37151,"Randolph County, North Carolina",7094,1617,5477,Randolph County, North Carolina
384,0500000US37155,"Robeson County, North Carolina",6515,3406,3109,Robeson County, North Carolina
385,0500000US37157,"Rockingham County, North Carolina",5521,1435,4086,Rockingham County, North Carolina
386,0500000US37159,"Rowan County, North Carolina",8529,1750,6779,Rowan County, North Carolina
387,0500000US37171,"Surry County, North Carolina",4493,816,3677,Surry County, North Carolina
388,0500000US37179,"Union County, North Carolina",7626,814,6812,Union County, North Carolina
389,0500000US37183,"Wake County, North Carolina",32964,4077,28887,Wake County, North Carolina
390,0500000US37191,"Wayne County, North Carolina",4062,916,3146,Wayne County, North Carolina
391,0500000US37195,"Wilson County, North Carolina",4300,1167,3133,Wilson County, North Carolina
392,0500000US39003,"Allen County, Ohio",5598,1490,4108,Allen County, Ohio
393,0500000US39007,"Ashtabula County, Ohio",5951,1172,4779,Ashtabula County, Ohio
394,0500000US39017,"Butler County, Ohio",15046,2081,12965,Butler County, Ohio
395,0500000US39023,"Clark County, Ohio",6222,1918,4304,Clark County, Ohio
396,0500000US39025,"Clermont County, Ohio",7594,1080,6514,Clermont County, Ohio
397,0500000US39029,"Columbiana County, Ohio",5542,1166,4376,Columbiana County, Ohio
398,0500000US39035,"Cuyahoga County, Ohio",50076,15299,34777,Cuyahoga County, Ohio
399,0500000US39041,"Delaware County, Ohio",6343,682,5661,Delaware County, Ohio
400,0500000US39045,"Fairfield County, Ohio",6132,597,5535,Fairfield County, Ohio
401,0500000US39049,"Franklin County, Ohio",39061,11083,27978,Franklin County, Ohio
402,0500000US39057,"Greene County, Ohio",7982,681,7301,Greene County, Ohio
403,0500000US39061,"Hamilton County, Ohio",28224,6808,21416,Hamilton County, Ohio
404,0500000US39085,"Lake County, Ohio",10461,865,9596,Lake County, Ohio
405,0500000US39089,"Licking County, Ohio",7305,944,6361,Licking County, Ohio
406,0500000US39093,"Lorain County, Ohio",14360,1876,12484,Lorain County, Ohio
407,0500000US39095,"Lucas County, Ohio",15581,3873,11708,Lucas County, Ohio
408,0500000US39099,"Mahoning County, Ohio",12804,3899,8905,Mahoning County, Ohio
409,0500000US39101,"Marion County, Ohio",3521,557,2964,Marion County, Ohio
410,0500000US39103,"Medina County, Ohio",8224,577,7647,Medina County, Ohio
411,0500000US39113,"Montgomery County, Ohio",22634,5051,17583,Montgomery County, Ohio
412,0500000US39119,"Muskingum County, Ohio",3293,743,2550,Muskingum County, Ohio
413,0500000US39133,"Portage County, Ohio",6380,992,5388,Portage County, Ohio
414,0500000US39145,"Scioto County, Ohio",5612,2257,3355,Scioto County, Ohio
415,0500000US39151,"Stark County, Ohio",18536,3775,14761,Stark County, Ohio
416,0500000US39153,"Summit County, Ohio",23409,4813,18596,Summit County, Ohio
417,0500000US39155,"Trumbull County, Ohio",13494,2979,10515,Trumbull County, Ohio
418,0500000US39157,"Tuscarawas County, Ohio",4285,457,3828,Tuscarawas County, Ohio
419,0500000US39165,"Warren County, Ohio",9249,178,9071,Warren County, Ohio
420,0500000US39169,"Wayne County, Ohio",4665,335,4330,Wayne County, Ohio
421,0500000US39173,"Wood County, Ohio",5584,397,5187,Wood County, Ohio
422,0500000US40017,"Canadian County, Oklahoma",4726,332,4394,Canadian County, Oklahoma
423,0500000US40027,"Cleveland County, Oklahoma",9443,1342,8101,Cleveland County, Oklahoma
424,0500000US40031,"Comanche County, Oklahoma",4897,838,4059,Comanche County, Oklahoma
425,0500000US40037,"Creek County, Oklahoma",4023,814,3209,Creek County, Oklahoma
426,0500000US40101,"Muskogee County, Oklahoma",3252,1006,2246,Muskogee County, Oklahoma
427,0500000US40109,"Oklahoma County, Oklahoma",28868,6073,22795,Oklahoma County, Oklahoma
428,0500000US40125,"Pottawatomie County, Oklahoma",3279,780,2499,Pottawatomie County, Oklahoma
429,0500000US40131,"Rogers County, Oklahoma",4060,490,3570,Rogers County, Oklahoma
430,0500000US40143,"Tulsa County, Oklahoma",22653,4449,18204,Tulsa County, Oklahoma
431,0500000US40145,"Wagoner County, Oklahoma",4116,324,3792,Wagoner County, Oklahoma
432,0500000US41005,"Clackamas County, Oregon",19841,1911,17930,Clackamas County, Oregon
433,0500000US41017,"Deschutes County, Oregon",11794,1130,10664,Deschutes County, Oregon
434,0500000US41019,"Douglas County, Oregon",7754,1656,6098,Douglas County, Oregon
435,0500000US41029,"Jackson County, Oregon",10784,1503,9281,Jackson County, Oregon
436,0500000US41033,"Josephine County, Oregon",6295,465,5830,Josephine County, Oregon
437,0500000US41035,"Klamath County, Oregon",4061,1282,2779,Klamath County, Oregon
438,0500000US41039,"Lane County, Oregon",20725,3559,17166,Lane County, Oregon
439,0500000US41043,"Linn County, Oregon",7048,1347,5701,Linn County, Oregon
440,0500000US41047,"Marion County, Oregon",13163,2699,10464,Marion County, Oregon
441,0500000US41051,"Multnomah County, Oregon",23138,4917,18221,Multnomah County, Oregon
442,0500000US41053,"Polk County, Oregon",4170,602,3568,Polk County, Oregon
443,0500000US41059,"Umatilla County, Oregon",4210,1060,3150,Umatilla County, Oregon
444,0500000US41067,"Washington County, Oregon",20576,3369,17207,Washington County, Oregon
445,0500000US41071,"Yamhill County, Oregon",3883,1022,2861,Yamhill County, Oregon
446,0500000US42001,"Adams County, Pennsylvania",4778,478,4300,Adams County, Pennsylvania
447,0500000US42003,"Allegheny County, Pennsylvania",50150,9177,40973,Allegheny County, Pennsylvania
448,0500000US42005,"Armstrong County, Pennsylvania",3800,455,3345,Armstrong County, Pennsylvania
449,0500000US42007,"Beaver County, Pennsylvania",8131,1308,6823,Beaver County, Pennsylvania
450,0500000US42011,"Berks County, Pennsylvania",17129,4292,12837,Berks County, Pennsylvania
451,0500000US42013,"Blair County, Pennsylvania",7047,1550,5497,Blair County, Pennsylvania
452,0500000US42017,"Bucks County, Pennsylvania",23823,2920,20903,Bucks County, Pennsylvania
453,0500000US42019,"Butler County, Pennsylvania",9399,914,8485,Butler County, Pennsylvania
454,0500000US42021,"Cambria County, Pennsylvania",8604,1196,7408,Cambria County, Pennsylvania
455,0500000US42029,"Chester County, Pennsylvania",15964,1505,14459,Chester County, Pennsylvania
456,0500000US42033,"Clearfield County, Pennsylvania",4183,736,3447,Clearfield County, Pennsylvania
457,0500000US42039,"Crawford County, Pennsylvania",5083,1273,3810,Crawford County, Pennsylvania
458,0500000US42041,"Cumberland County, Pennsylvania",11519,1270,10249,Cumberland County, Pennsylvania
459,0500000US42043,"Dauphin County, Pennsylvania",11727,1860,9867,Dauphin County, Pennsylvania
460,0500000US42045,"Delaware County, Pennsylvania",19172,5158,14014,Delaware County, Pennsylvania
461,0500000US42049,"Erie County, Pennsylvania",12027,2820,9207,Erie County, Pennsylvania
462,0500000US42051,"Fayette County, Pennsylvania",7910,1899,6011,Fayette County, Pennsylvania
463,0500000US42063,"Indiana County, Pennsylvania",4745,760,3985,Indiana County, Pennsylvania
464,0500000US42069,"Lackawanna County, Pennsylvania",8408,1729,6679,Lackawanna County, Pennsylvania
465,0500000US42071,"Lancaster County, Pennsylvania",20001,1981,18020,Lancaster County, Pennsylvania
466,0500000US42073,"Lawrence County, Pennsylvania",4005,619,3386,Lawrence County, Pennsylvania
467,0500000US42075,"Lebanon County, Pennsylvania",5816,806,5010,Lebanon County, Pennsylvania
468,0500000US42077,"Lehigh County, Pennsylvania",14315,2421,11894,Lehigh County, Pennsylvania
469,0500000US42079,"Luzerne County, Pennsylvania",14431,2748,11683,Luzerne County, Pennsylvania
470,0500000US42081,"Lycoming County, Pennsylvania",5569,643,4926,Lycoming County, Pennsylvania
471,0500000US42085,"Mercer County, Pennsylvania",6892,1212,5680,Mercer County, Pennsylvania
472,0500000US42091,"Montgomery County, Pennsylvania",27524,3215,24309,Montgomery County, Pennsylvania
473,0500000US42095,"Northampton County, Pennsylvania",13512,2006,11506,Northampton County, Pennsylvania
474,0500000US42097,"Northumberland County, Pennsylvania",4485,1097,3388,Northumberland County, Pennsylvania
475,0500000US42101,"Philadelphia County, Pennsylvania",58176,27912,30264,Philadelphia County, Pennsylvania
476,0500000US42107,"Schuylkill County, Pennsylvania",7684,1299,6385,Schuylkill County, Pennsylvania
477,0500000US42111,"Somerset County, Pennsylvania",4121,589,3532,Somerset County, Pennsylvania
478,0500000US42125,"Washington County, Pennsylvania",9229,1515,7714,Washington County, Pennsylvania
479,0500000US42129,"Westmoreland County, Pennsylvania",20664,3819,16845,Westmoreland County, Pennsylvania
480,0500000US42133,"York County, Pennsylvania",19959,1797,18162,York County, Pennsylvania
481,0500000US44003,"Kent County, Rhode Island",6977,886,6091,Kent County, Rhode Island
482,0500000US44007,"Providence County, Rhode Island",19895,7265,12630,Providence County, Rhode Island
483,0500000US45003,"Aiken County, South Carolina",9971,814,9157,Aiken County, South Carolina
484,0500000US45007,"Anderson County, South Carolina",11220,1978,9242,Anderson County, South Carolina
485,0500000US45015,"Berkeley County, South Carolina",9635,1380,8255,Berkeley County, South Carolina
486,0500000US45019,"Charleston County, South Carolina",17978,2043,15935,Charleston County, South Carolina
487,0500000US45035,"Dorchester County, South Carolina",5789,681,5108,Dorchester County, South Carolina
488,0500000US45041,"Florence County, South Carolina",6985,1830,5155,Florence County, South Carolina
489,0500000US45045,"Greenville County, South Carolina",21814,2579,19235,Greenville County, South Carolina
490,0500000US45051,"Horry County, South Carolina",26439,1426,25013,Horry County, South Carolina
491,0500000US45063,"Lexington County, South Carolina",12469,1733,10736,Lexington County, South Carolina
492,0500000US45077,"Pickens County, South Carolina",4732,358,4374,Pickens County, South Carolina
493,0500000US45079,"Richland County, South Carolina",15929,2535,13394,Richland County, South Carolina
494,0500000US45083,"Spartanburg County, South Carolina",14006,2828,11178,Spartanburg County, South Carolina
495,0500000US45091,"York County, South Carolina",11757,1499,10258,York County, South Carolina
496,0500000US46099,"Minnehaha County, South Dakota",5231,548,4683,Minnehaha County, South Dakota
497,0500000US47001,"Anderson County, Tennessee",3453,709,2744,Anderson County, Tennessee
498,0500000US47011,"Bradley County, Tennessee",5535,750,4785,Bradley County, Tennessee
499,0500000US47037,"Davidson County, Tennessee",19458,4165,15293,Davidson County, Tennessee
500,0500000US47065,"Hamilton County, Tennessee",15951,2250,13701,Hamilton County, Tennessee
501,0500000US47093,"Knox County, Tennessee",17475,3008,14467,Knox County, Tennessee
502,0500000US47113,"Madison County, Tennessee",3702,1086,2616,Madison County, Tennessee
503,0500000US47125,"Montgomery County, Tennessee",7864,1605,6259,Montgomery County, Tennessee
504,0500000US47147,"Robertson County, Tennessee",2610,799,1811,Robertson County, Tennessee
505,0500000US47149,"Rutherford County, Tennessee",8023,684,7339,Rutherford County, Tennessee
506,0500000US47155,"Sevier County, Tennessee",4358,994,3364,Sevier County, Tennessee
507,0500000US47157,"Shelby County, Tennessee",30367,8389,21978,Shelby County, Tennessee
508,0500000US47163,"Sullivan County, Tennessee",10446,2631,7815,Sullivan County, Tennessee
509,0500000US47165,"Sumner County, Tennessee",7714,1018,6696,Sumner County, Tennessee
510,0500000US47179,"Washington County, Tennessee",5593,586,5007,Washington County, Tennessee
511,0500000US48005,"Angelina County, Texas",3955,259,3696,Angelina County, Texas
512,0500000US48027,"Bell County, Texas",11421,1828,9593,Bell County, Texas
513,0500000US48029,"Bexar County, Texas",63892,14719,49173,Bexar County, Texas
514,0500000US48039,"Brazoria County, Texas",10957,1696,9261,Brazoria County, Texas
515,0500000US48041,"Brazos County, Texas",5031,479,4552,Brazos County, Texas
516,0500000US48061,"Cameron County, Texas",16064,4464,11600,Cameron County, Texas
517,0500000US48085,"Collin County, Texas",25979,2081,23898,Collin County, Texas
518,0500000US48113,"Dallas County, Texas",64368,14476,49892,Dallas County, Texas
519,0500000US48121,"Denton County, Texas",22747,2557,20190,Denton County, Texas
520,0500000US48135,"Ector County, Texas",3954,1394,2560,Ector County, Texas
521,0500000US48139,"Ellis County, Texas",6519,425,6094,Ellis County, Texas
522,0500000US48141,"El Paso County, Texas",26809,7858,18951,El Paso County, Texas
523,0500000US48157,"Fort Bend County, Texas",24508,1484,23024,Fort Bend County, Texas
524,0500000US48167,"Galveston County, Texas",12584,1242,11342,Galveston County, Texas
525,0500000US48181,"Grayson County, Texas",5923,286,5637,Grayson County, Texas
526,0500000US48183,"Gregg County, Texas",3615,561,3054,Gregg County, Texas
527,0500000US48187,"Guadalupe County, Texas",7274,1419,5855,Guadalupe County, Texas
528,0500000US48201,"Harris County, Texas",133273,36518,96755,Harris County, Texas
529,0500000US48209,"Hays County, Texas",6779,0,6779,Hays County, Texas
530,0500000US48215,"Hidalgo County, Texas",31160,11262,19898,Hidalgo County, Texas
531,0500000US48245,"Jefferson County, Texas",9389,2324,7065,Jefferson County, Texas
532,0500000US48303,"Lubbock County, Texas",10170,2117,8053,Lubbock County, Texas
533,0500000US48309,"McLennan County, Texas",7599,731,6868,McLennan County, Texas
534,0500000US48339,"Montgomery County, Texas",22958,3004,19954,Montgomery County, Texas
535,0500000US48355,"Nueces County, Texas",13576,3670,9906,Nueces County, Texas
536,0500000US48361,"Orange County, Texas",4270,605,3665,Orange County, Texas
537,0500000US48375,"Potter County, Texas",3865,627,3238,Potter County, Texas
538,0500000US48423,"Smith County, Texas",9995,1861,8134,Smith County, Texas
539,0500000US48439,"Tarrant County, Texas",52332,6545,45787,Tarrant County, Texas
540,0500000US48441,"Taylor County, Texas",5837,777,5060,Taylor County, Texas
541,0500000US48453,"Travis County, Texas",29122,3267,25855,Travis County, Texas
542,0500000US48479,"Webb County, Texas",7121,2800,4321,Webb County, Texas
543,0500000US48485,"Wichita County, Texas",3814,761,3053,Wichita County, Texas
544,0500000US48491,"Williamson County, Texas",17627,1346,16281,Williamson County, Texas
545,0500000US49005,"Cache County, Utah",3176,343,2833,Cache County, Utah
546,0500000US49011,"Davis County, Utah",8326,642,7684,Davis County, Utah
547,0500000US49035,"Salt Lake County, Utah",27068,2552,24516,Salt Lake County, Utah
548,0500000US49049,"Utah County, Utah",11389,381,11008,Utah County, Utah
549,0500000US49057,"Weber County, Utah",8363,987,7376,Weber County, Utah
550,0500000US51041,"Chesterfield County, Virginia",14468,1301,13167,Chesterfield County, Virginia
551,0500000US51059,"Fairfax County, Virginia",28903,2417,26486,Fairfax County, Virginia
552,0500000US51087,"Henrico County, Virginia",8768,1213,7555,Henrico County, Virginia
553,0500000US51107,"Loudoun County, Virginia",7793,121,7672,Loudoun County, Virginia
554,0500000US51153,"Prince William County, Virginia",9497,345,9152,Prince William County, Virginia
555,0500000US51177,"Spotsylvania County, Virginia",4117,138,3979,Spotsylvania County, Virginia
556,0500000US51179,"Stafford County, Virginia",3949,293,3656,Stafford County, Virginia
557,0500000US51550,"Chesapeake city, Virginia",7172,796,6376,Chesapeake city, Virginia
558,0500000US51650,"Hampton city, Virginia",4684,762,3922,Hampton city, Virginia
559,0500000US51700,"Newport News city, Virginia",5369,1562,3807,Newport News city, Virginia
560,0500000US51710,"Norfolk city, Virginia",6226,2305,3921,Norfolk city, Virginia
561,0500000US51740,"Portsmouth city, Virginia",5196,1773,3423,Portsmouth city, Virginia
562,0500000US51760,"Richmond city, Virginia",5992,1975,4017,Richmond city, Virginia
563,0500000US51800,"Suffolk city, Virginia",4304,770,3534,Suffolk city, Virginia
564,0500000US51810,"Virginia Beach city, Virginia",13477,1681,11796,Virginia Beach city, Virginia
565,0500000US53005,"Benton County, Washington",9417,1470,7947,Benton County, Washington
566,0500000US53011,"Clark County, Washington",20978,3196,17782,Clark County, Washington
567,0500000US53015,"Cowlitz County, Washington",5042,319,4723,Cowlitz County, Washington
568,0500000US53021,"Franklin County, Washington",2145,611,1534,Franklin County, Washington
569,0500000US53025,"Grant County, Washington",3171,913,2258,Grant County, Washington
570,0500000US53027,"Grays Harbor County, Washington",5444,1112,4332,Grays Harbor County, Washington
571,0500000US53033,"King County, Washington",64536,9740,54796,King County, Washington
572,0500000US53035,"Kitsap County, Washington",14711,1553,13158,Kitsap County, Washington
573,0500000US53041,"Lewis County, Washington",4006,671,3335,Lewis County, Washington
574,0500000US53053,"Pierce County, Washington",30168,4966,25202,Pierce County, Washington
575,0500000US53057,"Skagit County, Washington",8758,1558,7200,Skagit County, Washington
576,0500000US53061,"Snohomish County, Washington",28592,4408,24184,Snohomish County, Washington
577,0500000US53063,"Spokane County, Washington",22458,5073,17385,Spokane County, Washington
578,0500000US53067,"Thurston County, Washington",15709,3096,12613,Thurston County, Washington
579,0500000US53073,"Whatcom County, Washington",10673,2051,8622,Whatcom County, Washington
580,0500000US53077,"Yakima County, Washington",7907,2141,5766,Yakima County, Washington
581,0500000US54011,"Cabell County, West Virginia",4596,1373,3223,Cabell County, West Virginia
582,0500000US54033,"Harrison County, West Virginia",3949,887,3062,Harrison County, West Virginia
583,0500000US54039,"Kanawha County, West Virginia",12339,2303,10036,Kanawha County, West Virginia
584,0500000US54107,"Wood County, West Virginia",5075,1589,3486,Wood County, West Virginia
585,0500000US55009,"Brown County, Wisconsin",10259,1249,9010,Brown County, Wisconsin
586,0500000US55025,"Dane County, Wisconsin",18170,1515,16655,Dane County, Wisconsin
587,0500000US55027,"Dodge County, Wisconsin",2953,121,2832,Dodge County, Wisconsin
588,0500000US55059,"Kenosha County, Wisconsin",7003,1001,6002,Kenosha County, Wisconsin
589,0500000US55071,"Manitowoc County, Wisconsin",4965,664,4301,Manitowoc County, Wisconsin
590,0500000US55073,"Marathon County, Wisconsin",5857,447,5410,Marathon County, Wisconsin
591,0500000US55079,"Milwaukee County, Wisconsin",30342,9185,21157,Milwaukee County, Wisconsin
592,0500000US55087,"Outagamie County, Wisconsin",7168,395,6773,Outagamie County, Wisconsin
593,0500000US55101,"Racine County, Wisconsin",7938,671,7267,Racine County, Wisconsin
594,0500000US55105,"Rock County, Wisconsin",6448,856,5592,Rock County, Wisconsin
595,0500000US55111,"Sauk County, Wisconsin",2865,293,2572,Sauk County, Wisconsin
596,0500000US55117,"Sheboygan County, Wisconsin",4994,361,4633,Sheboygan County, Wisconsin
597,0500000US55127,"Walworth County, Wisconsin",4621,312,4309,Walworth County, Wisconsin
598,0500000US55133,"Waukesha County, Wisconsin",18942,1040,17902,Waukesha County, Wisconsin
599,0500000US55139,"Winnebago County, Wisconsin",7427,576,6851,Winnebago County, Wisconsin
600,0500000US55141,"Wood County, Wisconsin",5022,477,4545,Wood County, Wisconsin
601,0500000US72021,"Bayamón Municipio, Puerto Rico",14758,8003,6755,Bayamón Municipio, Puerto Rico
602,0500000US72025,"Caguas Municipio, Puerto Rico",7588,4239,3349,Caguas Municipio, Puerto Rico
603,0500000US72031,"Carolina Municipio, Puerto Rico",10463,5912,4551,Carolina Municipio, Puerto Rico
604,0500000US72061,"Guaynabo Municipio, Puerto Rico",5627,1753,3874,Guaynabo Municipio, Puerto Rico
605,0500000US72113,"Ponce Municipio, Puerto Rico",11656,7624,4032,Ponce Municipio, Puerto Rico
606,0500000US72127,"San Juan Municipio, Puerto Rico",23670,13701,9969,San Juan Municipio, Puerto Rico
607,0500000US72135,"Toa Alta Municipio, Puerto Rico",4018,1856,2162,Toa Alta Municipio, Puerto Rico
608,0500000US72137,"Toa Baja Municipio, Puerto Rico",4295,2243,2052,Toa Baja Municipio, Puerto Rico
609,0500000US72139,"Trujillo Alto Municipio, Puerto Rico",3521,1089,2432,Trujillo Alto Municipio, Puerto Rico
