FIPS,Jan22 SNAP Households,Jan22 ACP Total Households,State,State Name,County Name,Oct22 ACP Total Households,Latest SNAP to ACP Difference
08001,25542,10338,CO,COLORADO,ADAMS COUNTY,15650,9892
08003,2411,728,CO,COLORADO,ALAMOSA COUNTY,1590,821
08005,27140,10682,CO,COLORADO,ARAPAHOE COUNTY,16426,10714
08007,777,71,CO,COLORADO,ARCHULETA COUNTY,119,658
08009,323,43,CO,COLORADO,BACA COUNTY,89,234
08011,522,213,CO,COLORADO,BENT COUNTY,346,176
08013,9494,4119,CO,COLORADO,BOULDER COUNTY,6111,3383
08014,1400,454,CO,COLORADO,BROOMFIELD COUNTY,764,636
08015,952,207,CO,COLORADO,CHAFFEE COUNTY,480,472
08017,85,6,CO,COLORADO,CHEYENNE COUNTY,13,72
08019,339,103,CO,COLORADO,CLEAR CREEK COUNTY,173,166
08021,821,93,CO,COLORADO,CONEJOS COUNTY,277,544
08023,660,47,CO,COLORADO,COSTILLA COUNTY,241,419
08025,527,113,CO,COLORADO,CROWLEY COUNTY,169,358
08027,264,32,CO,COLORADO,CUSTER COUNTY,52,212
08029,2182,711,CO,COLORADO,DELTA COUNTY,1168,1014
08031,42910,20689,CO,COLORADO,DENVER COUNTY,30854,12056
08033,135,9,CO,COLORADO,DOLORES COUNTY,23,112
08035,3549,1241,CO,COLORADO,DOUGLAS COUNTY,2168,1381
08037,674,127,CO,COLORADO,EAGLE COUNTY,199,475
08039,406,77,CO,COLORADO,ELBERT COUNTY,148,258
08041,37703,14249,CO,COLORADO,EL PASO COUNTY,22737,14966
08043,3943,1705,CO,COLORADO,FREMONT COUNTY,2960,983
08045,2098,621,CO,COLORADO,GARFIELD COUNTY,878,1220
08047,272,28,CO,COLORADO,GILPIN COUNTY,62,210
08049,243,66,CO,COLORADO,GRAND COUNTY,103,140
08051,593,159,CO,COLORADO,GUNNISON COUNTY,312,281
08053,11,0,CO,COLORADO,HINSDALE COUNTY,2,9
08055,992,367,CO,COLORADO,HUERFANO COUNTY,640,352
08057,58,4,CO,COLORADO,JACKSON COUNTY,12,46
08059,16989,7766,CO,COLORADO,JEFFERSON COUNTY,11625,5364
08061,96,8,CO,COLORADO,KIOWA COUNTY,17,79
08063,416,39,CO,COLORADO,KIT CARSON COUNTY,100,316
08065,260,115,CO,COLORADO,LAKE COUNTY,252,8
08067,2295,654,CO,COLORADO,LA PLATA COUNTY,1183,1112
08069,13963,4759,CO,COLORADO,LARIMER COUNTY,7383,6580
08071,1829,524,CO,COLORADO,LAS ANIMAS COUNTY,1106,723
08073,349,49,CO,COLORADO,LINCOLN COUNTY,71,278
08075,1447,736,CO,COLORADO,LOGAN COUNTY,1160,287
08077,9792,5480,CO,COLORADO,MESA COUNTY,9209,583
08079,38,2,CO,COLORADO,MINERAL COUNTY,5,33
08081,750,357,CO,COLORADO,MOFFAT COUNTY,553,197
08083,2284,447,CO,COLORADO,MONTEZUMA COUNTY,717,1567
08085,2738,949,CO,COLORADO,MONTROSE COUNTY,1532,1206
08087,1566,679,CO,COLORADO,MORGAN COUNTY,1114,452
08089,2269,1190,CO,COLORADO,OTERO COUNTY,1931,338
08091,117,11,CO,COLORADO,OURAY COUNTY,18,99
08093,737,88,CO,COLORADO,PARK COUNTY,161,576
08095,220,31,CO,COLORADO,PHILLIPS COUNTY,61,159
08097,193,44,CO,COLORADO,PITKIN COUNTY,75,118
08099,1340,497,CO,COLORADO,PROWERS COUNTY,910,430
08101,20986,9535,CO,COLORADO,PUEBLO COUNTY,13700,7286
08103,324,41,CO,COLORADO,RIO BLANCO COUNTY,80,244
08105,1200,346,CO,COLORADO,RIO GRANDE COUNTY,703,497
08107,341,55,CO,COLORADO,ROUTT COUNTY,95,246
08109,718,79,CO,COLORADO,SAGUACHE COUNTY,253,465
08111,24,0,CO,COLORADO,SAN JUAN COUNTY,1,23
08113,162,22,CO,COLORADO,SAN MIGUEL COUNTY,48,114
08115,207,41,CO,COLORADO,SEDGWICK COUNTY,45,162
08117,443,100,CO,COLORADO,SUMMIT COUNTY,166,277
08119,1285,196,CO,COLORADO,TELLER COUNTY,309,976
08121,265,25,CO,COLORADO,WASHINGTON COUNTY,54,211
08123,14107,5384,CO,COLORADO,WELD COUNTY,7539,6568
08125,575,25,CO,COLORADO,YUMA COUNTY,73,502
24001,9028,2142,MD,MARYLAND,ALLEGANY COUNTY,2806,6222
24003,35629,6970,MD,MARYLAND,ANNE ARUNDEL COUNTY,9621,26008
24005,71869,18558,MD,MARYLAND,BALTIMORE COUNTY,26113,45756
24009,4729,1062,MD,MARYLAND,CALVERT COUNTY,1443,3286
24011,3534,740,MD,MARYLAND,CAROLINE COUNTY,925,2609
24013,5931,1641,MD,MARYLAND,CARROLL COUNTY,2285,3646
24015,8459,2392,MD,MARYLAND,CECIL COUNTY,3192,5267
24017,11744,2903,MD,MARYLAND,CHARLES COUNTY,3260,8484
24019,5232,1365,MD,MARYLAND,DORCHESTER COUNTY,1663,3569
24021,10895,2789,MD,MARYLAND,FREDERICK COUNTY,3901,6994
24023,2365,562,MD,MARYLAND,GARRETT COUNTY,797,1568
24025,14063,3850,MD,MARYLAND,HARFORD COUNTY,5185,8878
24027,12687,2859,MD,MARYLAND,HOWARD COUNTY,4077,8610
24029,1965,284,MD,MARYLAND,KENT COUNTY,412,1553
24031,42150,10262,MD,MARYLAND,MONTGOMERY COUNTY,14543,27607
24033,85463,19031,MD,MARYLAND,PRINCE GEORGE'S COUNTY,23552,61911
24035,2064,463,MD,MARYLAND,QUEEN ANNE'S COUNTY,570,1494
24037,7201,1789,MD,MARYLAND,ST. MARY'S COUNTY,2151,5050
24039,3399,1474,MD,MARYLAND,SOMERSET COUNTY,1550,1849
24041,2870,425,MD,MARYLAND,TALBOT COUNTY,574,2296
24043,14835,4344,MD,MARYLAND,WASHINGTON COUNTY,5337,9498
24045,12348,3776,MD,MARYLAND,WICOMICO COUNTY,4784,7564
24047,4459,1455,MD,MARYLAND,WORCESTER COUNTY,1531,2928
24510,125590,47785,MD,MARYLAND,BALTIMORE CITY,54970,70620
26001,739,264,MI,MICHIGAN,ALCONA COUNTY,489,250
26003,421,110,MI,MICHIGAN,ALGER COUNTY,237,184
26005,4977,2530,MI,MICHIGAN,ALLEGAN COUNTY,4265,712
26007,2350,1731,MI,MICHIGAN,ALPENA COUNTY,2700,-350
26009,1076,433,MI,MICHIGAN,ANTRIM COUNTY,844,232
26011,1175,529,MI,MICHIGAN,ARENAC COUNTY,834,341
26013,530,231,MI,MICHIGAN,BARAGA COUNTY,402,128
26015,2545,860,MI,MICHIGAN,BARRY COUNTY,1386,1159
26017,7922,5333,MI,MICHIGAN,BAY COUNTY,8920,-998
26019,723,292,MI,MICHIGAN,BENZIE COUNTY,619,104
26021,11165,5093,MI,MICHIGAN,BERRIEN COUNTY,7616,3549
26023,2448,1507,MI,MICHIGAN,BRANCH COUNTY,2424,24
26025,11957,5073,MI,MICHIGAN,CALHOUN COUNTY,7383,4574
26027,3082,1296,MI,MICHIGAN,CASS COUNTY,1959,1123
26029,966,510,MI,MICHIGAN,CHARLEVOIX COUNTY,1009,-43
26031,1687,766,MI,MICHIGAN,CHEBOYGAN COUNTY,1219,468
26033,2053,1256,MI,MICHIGAN,CHIPPEWA COUNTY,2197,-144
26035,3404,2018,MI,MICHIGAN,CLARE COUNTY,3141,263
26037,2419,1165,MI,MICHIGAN,CLINTON COUNTY,1814,605
26039,1117,602,MI,MICHIGAN,CRAWFORD COUNTY,1042,75
26041,2297,1134,MI,MICHIGAN,DELTA COUNTY,2439,-142
26043,1385,768,MI,MICHIGAN,DICKINSON COUNTY,1583,-198
26045,5273,2277,MI,MICHIGAN,EATON COUNTY,3081,2192
26047,1147,542,MI,MICHIGAN,EMMET COUNTY,1210,-63
26049,42225,20436,MI,MICHIGAN,GENESEE COUNTY,29014,13211
26051,2012,1023,MI,MICHIGAN,GLADWIN COUNTY,1780,232
26053,1318,695,MI,MICHIGAN,GOGEBIC COUNTY,1280,38
26055,3471,1662,MI,MICHIGAN,GRAND TRAVERSE COUNTY,3782,-311
26057,2492,1312,MI,MICHIGAN,GRATIOT COUNTY,2312,180
26059,2902,1113,MI,MICHIGAN,HILLSDALE COUNTY,1653,1249
26061,1742,977,MI,MICHIGAN,HOUGHTON COUNTY,1893,-151
26063,1833,562,MI,MICHIGAN,HURON COUNTY,851,982
26065,20999,9228,MI,MICHIGAN,INGHAM COUNTY,12491,8508
26067,3461,1807,MI,MICHIGAN,IONIA COUNTY,2947,514
26069,2435,1420,MI,MICHIGAN,IOSCO COUNTY,2364,71
26071,865,163,MI,MICHIGAN,IRON COUNTY,271,594
26073,4071,2320,MI,MICHIGAN,ISABELLA COUNTY,3555,516
26075,10350,5073,MI,MICHIGAN,JACKSON COUNTY,6446,3904
26077,17053,10993,MI,MICHIGAN,KALAMAZOO COUNTY,17399,-346
26079,1170,498,MI,MICHIGAN,KALKASKA COUNTY,884,286
26081,36062,16606,MI,MICHIGAN,KENT COUNTY,23223,12839
26083,89,38,MI,MICHIGAN,KEWEENAW COUNTY,82,7
26085,1496,472,MI,MICHIGAN,LAKE COUNTY,731,765
26087,3917,1855,MI,MICHIGAN,LAPEER COUNTY,3566,351
26089,388,173,MI,MICHIGAN,LEELANAU COUNTY,473,-85
26091,5260,2061,MI,MICHIGAN,LENAWEE COUNTY,2990,2270
26093,4194,1443,MI,MICHIGAN,LIVINGSTON COUNTY,2724,1470
26095,451,226,MI,MICHIGAN,LUCE COUNTY,305,146
26097,501,209,MI,MICHIGAN,MACKINAC COUNTY,347,154
26099,53831,22208,MI,MICHIGAN,MACOMB COUNTY,36354,17477
26101,1694,751,MI,MICHIGAN,MANISTEE COUNTY,1316,378
26103,3229,1888,MI,MICHIGAN,MARQUETTE COUNTY,3359,-130
26105,2049,990,MI,MICHIGAN,MASON COUNTY,1692,357
26107,2681,1445,MI,MICHIGAN,MECOSTA COUNTY,2315,366
26109,1269,645,MI,MICHIGAN,MENOMINEE COUNTY,1262,7
26111,4448,2476,MI,MICHIGAN,MIDLAND COUNTY,4343,105
26113,929,339,MI,MICHIGAN,MISSAUKEE COUNTY,604,325
26115,7771,3729,MI,MICHIGAN,MONROE COUNTY,6044,1727
26117,4235,2205,MI,MICHIGAN,MONTCALM COUNTY,3610,625
26119,774,191,MI,MICHIGAN,MONTMORENCY COUNTY,286,488
26121,17301,8081,MI,MICHIGAN,MUSKEGON COUNTY,10936,6365
26123,3893,1611,MI,MICHIGAN,NEWAYGO COUNTY,2656,1237
26125,51353,20871,MI,MICHIGAN,OAKLAND COUNTY,32452,18901
26127,2073,864,MI,MICHIGAN,OCEANA COUNTY,1365,708
26129,2071,1116,MI,MICHIGAN,OGEMAW COUNTY,1822,249
26131,380,129,MI,MICHIGAN,ONTONAGON COUNTY,275,105
26133,1582,822,MI,MICHIGAN,OSCEOLA COUNTY,1184,398
26135,792,208,MI,MICHIGAN,OSCODA COUNTY,484,308
26137,1616,808,MI,MICHIGAN,OTSEGO COUNTY,1406,210
26139,8048,3758,MI,MICHIGAN,OTTAWA COUNTY,7325,723
26141,829,289,MI,MICHIGAN,PRESQUE ISLE COUNTY,498,331
26143,2297,1497,MI,MICHIGAN,ROSCOMMON COUNTY,2537,-240
26145,19078,13155,MI,MICHIGAN,SAGINAW COUNTY,20986,-1908
26147,10769,4442,MI,MICHIGAN,ST. CLAIR COUNTY,6316,4453
26149,3786,2019,MI,MICHIGAN,ST. JOSEPH COUNTY,3138,648
26151,2736,796,MI,MICHIGAN,SANILAC COUNTY,1202,1534
26153,562,344,MI,MICHIGAN,SCHOOLCRAFT COUNTY,593,-31
26155,4056,2021,MI,MICHIGAN,SHIAWASSEE COUNTY,3684,372
26157,3591,1512,MI,MICHIGAN,TUSCOLA COUNTY,2689,902
26159,5462,2026,MI,MICHIGAN,VAN BUREN COUNTY,3137,2325
26161,14496,6379,MI,MICHIGAN,WASHTENAW COUNTY,9260,5236
26163,214779,113435,MI,MICHIGAN,WAYNE COUNTY,154256,60523
26165,2748,1319,MI,MICHIGAN,WEXFORD COUNTY,2279,469
36000,1626534,655669,NY,NEW YORK,**NOT AVAILABLE**,1048379,578155
37001,14759,7241,NC,NORTH CAROLINA,ALAMANCE COUNTY,11346,3413
37003,2445,1258,NC,NORTH CAROLINA,ALEXANDER COUNTY,2007,438
37005,854,86,NC,NORTH CAROLINA,ALLEGHANY COUNTY,220,634
37007,3883,1983,NC,NORTH CAROLINA,ANSON COUNTY,2266,1617
37009,2243,201,NC,NORTH CAROLINA,ASHE COUNTY,329,1914
37011,1107,312,NC,NORTH CAROLINA,AVERY COUNTY,590,517
37013,5401,1337,NC,NORTH CAROLINA,BEAUFORT COUNTY,2349,3052
37015,2884,523,NC,NORTH CAROLINA,BERTIE COUNTY,1282,1602
37017,4555,1821,NC,NORTH CAROLINA,BLADEN COUNTY,3081,1474
37019,8782,2666,NC,NORTH CAROLINA,BRUNSWICK COUNTY,5116,3666
37021,20364,7745,NC,NORTH CAROLINA,BUNCOMBE COUNTY,13720,6644
37023,7315,3396,NC,NORTH CAROLINA,BURKE COUNTY,5693,1622
37025,13263,6003,NC,NORTH CAROLINA,CABARRUS COUNTY,10520,2743
37027,7948,4786,NC,NORTH CAROLINA,CALDWELL COUNTY,7515,433
37029,495,66,NC,NORTH CAROLINA,CAMDEN COUNTY,131,364
37031,4307,2003,NC,NORTH CAROLINA,CARTERET COUNTY,3681,626
37033,2476,589,NC,NORTH CAROLINA,CASWELL COUNTY,954,1522
37035,12930,6625,NC,NORTH CAROLINA,CATAWBA COUNTY,11061,1869
37037,2965,1124,NC,NORTH CAROLINA,CHATHAM COUNTY,2179,786
37039,2694,798,NC,NORTH CAROLINA,CHEROKEE COUNTY,1112,1582
37041,1631,312,NC,NORTH CAROLINA,CHOWAN COUNTY,633,998
37043,892,183,NC,NORTH CAROLINA,CLAY COUNTY,266,626
37045,12973,6119,NC,NORTH CAROLINA,CLEVELAND COUNTY,9059,3914
37047,6853,3652,NC,NORTH CAROLINA,COLUMBUS COUNTY,5174,1679
37049,7827,2734,NC,NORTH CAROLINA,CRAVEN COUNTY,4418,3409
37051,42653,20393,NC,NORTH CAROLINA,CUMBERLAND COUNTY,31904,10749
37053,1090,188,NC,NORTH CAROLINA,CURRITUCK COUNTY,345,745
37055,1682,315,NC,NORTH CAROLINA,DARE COUNTY,854,828
37057,14770,7077,NC,NORTH CAROLINA,DAVIDSON COUNTY,11155,3615
37059,2597,1000,NC,NORTH CAROLINA,DAVIE COUNTY,1745,852
37061,4792,1836,NC,NORTH CAROLINA,DUPLIN COUNTY,3349,1443
37063,24898,10610,NC,NORTH CAROLINA,DURHAM COUNTY,16885,8013
37065,8771,3399,NC,NORTH CAROLINA,EDGECOMBE COUNTY,4572,4199
37067,34839,16291,NC,NORTH CAROLINA,FORSYTH COUNTY,26303,8536
37069,5251,1942,NC,NORTH CAROLINA,FRANKLIN COUNTY,3461,1790
37071,22012,10903,NC,NORTH CAROLINA,GASTON COUNTY,17309,4703
37073,951,175,NC,NORTH CAROLINA,GATES COUNTY,342,609
37075,843,144,NC,NORTH CAROLINA,GRAHAM COUNTY,239,604
37077,4473,1746,NC,NORTH CAROLINA,GRANVILLE COUNTY,3206,1267
37079,2281,686,NC,NORTH CAROLINA,GREENE COUNTY,971,1310
37081,56353,26097,NC,NORTH CAROLINA,GUILFORD COUNTY,38672,17681
37083,9056,4067,NC,NORTH CAROLINA,HALIFAX COUNTY,5376,3680
37085,10719,4468,NC,NORTH CAROLINA,HARNETT COUNTY,7939,2780
37087,5136,1968,NC,NORTH CAROLINA,HAYWOOD COUNTY,3292,1844
37089,6307,1116,NC,NORTH CAROLINA,HENDERSON COUNTY,1825,4482
37091,3581,1133,NC,NORTH CAROLINA,HERTFORD COUNTY,2271,1310
37093,5570,2284,NC,NORTH CAROLINA,HOKE COUNTY,3713,1857
37095,560,49,NC,NORTH CAROLINA,HYDE COUNTY,106,454
37097,8140,5222,NC,NORTH CAROLINA,IREDELL COUNTY,8586,-446
37099,2740,398,NC,NORTH CAROLINA,JACKSON COUNTY,645,2095
37101,15177,5625,NC,NORTH CAROLINA,JOHNSTON COUNTY,10095,5082
37103,1133,355,NC,NORTH CAROLINA,JONES COUNTY,620,513
37105,5062,2502,NC,NORTH CAROLINA,LEE COUNTY,4323,739
37107,8179,3045,NC,NORTH CAROLINA,LENOIR COUNTY,4324,3855
37109,5918,2735,NC,NORTH CAROLINA,LINCOLN COUNTY,4543,1375
37111,5001,1764,NC,NORTH CAROLINA,MCDOWELL COUNTY,2891,2110
37113,2508,489,NC,NORTH CAROLINA,MACON COUNTY,710,1798
37115,1906,325,NC,NORTH CAROLINA,MADISON COUNTY,504,1402
37117,2942,650,NC,NORTH CAROLINA,MARTIN COUNTY,1152,1790
37119,86662,36280,NC,NORTH CAROLINA,MECKLENBURG COUNTY,55386,31276
37121,1394,406,NC,NORTH CAROLINA,MITCHELL COUNTY,668,726
37123,2238,1089,NC,NORTH CAROLINA,MONTGOMERY COUNTY,1287,951
37125,5662,2043,NC,NORTH CAROLINA,MOORE COUNTY,3677,1985
37127,10171,3630,NC,NORTH CAROLINA,NASH COUNTY,5135,5036
37129,16919,6888,NC,NORTH CAROLINA,NEW HANOVER COUNTY,12987,3932
37131,2938,1090,NC,NORTH CAROLINA,NORTHAMPTON COUNTY,1289,1649
37133,11762,6390,NC,NORTH CAROLINA,ONSLOW COUNTY,11116,646
37135,6729,2270,NC,NORTH CAROLINA,ORANGE COUNTY,4727,2002
37137,1058,378,NC,NORTH CAROLINA,PAMLICO COUNTY,737,321
37139,4280,1760,NC,NORTH CAROLINA,PASQUOTANK COUNTY,3091,1189
37141,4237,1304,NC,NORTH CAROLINA,PENDER COUNTY,2858,1379
37143,1310,292,NC,NORTH CAROLINA,PERQUIMANS COUNTY,448,862
37145,3922,1910,NC,NORTH CAROLINA,PERSON COUNTY,2833,1089
37147,20963,6619,NC,NORTH CAROLINA,PITT COUNTY,10526,10437
37149,1154,343,NC,NORTH CAROLINA,POLK COUNTY,609,545
37151,12230,5933,NC,NORTH CAROLINA,RANDOLPH COUNTY,9476,2754
37153,8024,4202,NC,NORTH CAROLINA,RICHMOND COUNTY,6046,1978
37155,23577,9917,NC,NORTH CAROLINA,ROBESON COUNTY,15747,7830
37157,9593,5395,NC,NORTH CAROLINA,ROCKINGHAM COUNTY,8330,1263
37159,12388,7016,NC,NORTH CAROLINA,ROWAN COUNTY,10659,1729
37161,7359,1830,NC,NORTH CAROLINA,RUTHERFORD COUNTY,2617,4742
37163,6721,1690,NC,NORTH CAROLINA,SAMPSON COUNTY,2807,3914
37165,5916,3460,NC,NORTH CAROLINA,SCOTLAND COUNTY,4861,1055
37167,5221,2669,NC,NORTH CAROLINA,STANLY COUNTY,3910,1311
37169,3449,1309,NC,NORTH CAROLINA,STOKES COUNTY,2373,1076
37171,6773,2773,NC,NORTH CAROLINA,SURRY COUNTY,4772,2001
37173,1278,211,NC,NORTH CAROLINA,SWAIN COUNTY,510,768
37175,2105,319,NC,NORTH CAROLINA,TRANSYLVANIA COUNTY,574,1531
37177,431,44,NC,NORTH CAROLINA,TYRRELL COUNTY,122,309
37179,10330,4081,NC,NORTH CAROLINA,UNION COUNTY,7370,2960
37181,7623,4124,NC,NORTH CAROLINA,VANCE COUNTY,5899,1724
37183,52435,19187,NC,NORTH CAROLINA,WAKE COUNTY,36241,16194
37185,2527,716,NC,NORTH CAROLINA,WARREN COUNTY,1116,1411
37187,1788,381,NC,NORTH CAROLINA,WASHINGTON COUNTY,701,1087
37189,1624,859,NC,NORTH CAROLINA,WATAUGA COUNTY,1636,-12
37191,13459,6945,NC,NORTH CAROLINA,WAYNE COUNTY,11036,2423
37193,6591,3088,NC,NORTH CAROLINA,WILKES COUNTY,5246,1345
37195,9595,5903,NC,NORTH CAROLINA,WILSON COUNTY,8598,997
37197,2570,1068,NC,NORTH CAROLINA,YADKIN COUNTY,1855,715
37199,1748,344,NC,NORTH CAROLINA,YANCEY COUNTY,615,1133
42001,3650,1269,PA,PENNSYLVANIA,ADAMS COUNTY,1828,1822
42003,91042,33732,PA,PENNSYLVANIA,ALLEGHENY COUNTY,46779,44263
42005,5595,1564,PA,PENNSYLVANIA,ARMSTRONG COUNTY,2457,3138
42007,13062,4099,PA,PENNSYLVANIA,BEAVER COUNTY,6001,7061
42009,3374,824,PA,PENNSYLVANIA,BEDFORD COUNTY,1204,2170
42011,29590,9360,PA,PENNSYLVANIA,BERKS COUNTY,18098,11492
42013,11334,3948,PA,PENNSYLVANIA,BLAIR COUNTY,5351,5983
42015,4054,1160,PA,PENNSYLVANIA,BRADFORD COUNTY,1873,2181
42017,21602,6116,PA,PENNSYLVANIA,BUCKS COUNTY,9571,12031
42019,8348,2018,PA,PENNSYLVANIA,BUTLER COUNTY,3288,5060
42021,12916,4505,PA,PENNSYLVANIA,CAMBRIA COUNTY,6507,6409
42023,512,146,PA,PENNSYLVANIA,CAMERON COUNTY,217,295
42025,4195,1283,PA,PENNSYLVANIA,CARBON COUNTY,2104,2091
42027,4396,1315,PA,PENNSYLVANIA,CENTRE COUNTY,2132,2264
42029,14223,4162,PA,PENNSYLVANIA,CHESTER COUNTY,6429,7794
42031,2789,790,PA,PENNSYLVANIA,CLARION COUNTY,1294,1495
42033,6755,2178,PA,PENNSYLVANIA,CLEARFIELD COUNTY,2951,3804
42035,2841,866,PA,PENNSYLVANIA,CLINTON COUNTY,1287,1554
42037,4427,1215,PA,PENNSYLVANIA,COLUMBIA COUNTY,1801,2626
42039,6916,2226,PA,PENNSYLVANIA,CRAWFORD COUNTY,3214,3702
42041,10700,3310,PA,PENNSYLVANIA,CUMBERLAND COUNTY,5294,5406
42043,25409,10550,PA,PENNSYLVANIA,DAUPHIN COUNTY,14786,10623
42045,38314,13575,PA,PENNSYLVANIA,DELAWARE COUNTY,20905,17409
42047,1952,659,PA,PENNSYLVANIA,ELK COUNTY,1014,938
42049,27416,15949,PA,PENNSYLVANIA,ERIE COUNTY,23336,4080
42051,16260,4632,PA,PENNSYLVANIA,FAYETTE COUNTY,6661,9599
42053,407,51,PA,PENNSYLVANIA,FOREST COUNTY,95,312
42055,8473,2818,PA,PENNSYLVANIA,FRANKLIN COUNTY,3939,4534
42057,963,388,PA,PENNSYLVANIA,FULTON COUNTY,382,581
42059,3609,931,PA,PENNSYLVANIA,GREENE COUNTY,1529,2080
42061,2766,688,PA,PENNSYLVANIA,HUNTINGDON COUNTY,1285,1481
42063,6087,1819,PA,PENNSYLVANIA,INDIANA COUNTY,2686,3401
42065,3211,1139,PA,PENNSYLVANIA,JEFFERSON COUNTY,1728,1483
42067,1216,208,PA,PENNSYLVANIA,JUNIATA COUNTY,328,888
42069,20881,7647,PA,PENNSYLVANIA,LACKAWANNA COUNTY,10933,9948
42071,26509,9783,PA,PENNSYLVANIA,LANCASTER COUNTY,14244,12265
42073,8887,3025,PA,PENNSYLVANIA,LAWRENCE COUNTY,4229,4658
42075,8189,2823,PA,PENNSYLVANIA,LEBANON COUNTY,4932,3257
42077,27379,8349,PA,PENNSYLVANIA,LEHIGH COUNTY,15285,12094
42079,32482,11358,PA,PENNSYLVANIA,LUZERNE COUNTY,16308,16174
42081,8940,2964,PA,PENNSYLVANIA,LYCOMING COUNTY,4473,4467
42083,3751,1010,PA,PENNSYLVANIA,MCKEAN COUNTY,1439,2312
42085,10158,4627,PA,PENNSYLVANIA,MERCER COUNTY,7288,2870
42087,3774,989,PA,PENNSYLVANIA,MIFFLIN COUNTY,1483,2291
42089,11237,2361,PA,PENNSYLVANIA,MONROE COUNTY,3838,7399
42091,30537,9016,PA,PENNSYLVANIA,MONTGOMERY COUNTY,13691,16846
42093,909,234,PA,PENNSYLVANIA,MONTOUR COUNTY,318,591
42095,16633,4600,PA,PENNSYLVANIA,NORTHAMPTON COUNTY,8410,8223
42097,8180,2431,PA,PENNSYLVANIA,NORTHUMBERLAND COUNTY,3663,4517
42099,2222,581,PA,PENNSYLVANIA,PERRY COUNTY,826,1396
42101,266602,98106,PA,PENNSYLVANIA,PHILADELPHIA COUNTY,134506,132096
42103,3080,601,PA,PENNSYLVANIA,PIKE COUNTY,1039,2041
42105,1134,222,PA,PENNSYLVANIA,POTTER COUNTY,358,776
42107,11986,4063,PA,PENNSYLVANIA,SCHUYLKILL COUNTY,6211,5775
42109,1621,327,PA,PENNSYLVANIA,SNYDER COUNTY,500,1121
42111,5561,1599,PA,PENNSYLVANIA,SOMERSET COUNTY,2432,3129
42113,320,47,PA,PENNSYLVANIA,SULLIVAN COUNTY,90,230
42115,2294,670,PA,PENNSYLVANIA,SUSQUEHANNA COUNTY,950,1344
42117,2889,645,PA,PENNSYLVANIA,TIOGA COUNTY,1149,1740
42119,1622,451,PA,PENNSYLVANIA,UNION COUNTY,691,931
42121,4739,1880,PA,PENNSYLVANIA,VENANGO COUNTY,3049,1690
42123,2932,722,PA,PENNSYLVANIA,WARREN COUNTY,1061,1871
42125,15151,4461,PA,PENNSYLVANIA,WASHINGTON COUNTY,6633,8518
42127,3124,733,PA,PENNSYLVANIA,WAYNE COUNTY,1159,1965
42129,24333,7358,PA,PENNSYLVANIA,WESTMORELAND COUNTY,10964,13369
42131,1894,366,PA,PENNSYLVANIA,WYOMING COUNTY,623,1271
42133,26108,8914,PA,PENNSYLVANIA,YORK COUNTY,14125,11983
45001,1780,952,SC,SOUTH CAROLINA,ABBEVILLE COUNTY,1627,153
45003,10510,4768,SC,SOUTH CAROLINA,AIKEN COUNTY,6858,3652
45005,1222,578,SC,SOUTH CAROLINA,ALLENDALE COUNTY,874,348
45007,11940,9103,SC,SOUTH CAROLINA,ANDERSON COUNTY,14742,-2802
45009,1753,774,SC,SOUTH CAROLINA,BAMBERG COUNTY,1079,674
45011,2523,1058,SC,SOUTH CAROLINA,BARNWELL COUNTY,1554,969
45013,5257,1683,SC,SOUTH CAROLINA,BEAUFORT COUNTY,3050,2207
45015,9454,3698,SC,SOUTH CAROLINA,BERKELEY COUNTY,5996,3458
45017,1208,606,SC,SOUTH CAROLINA,CALHOUN COUNTY,890,318
45019,16930,8527,SC,SOUTH CAROLINA,CHARLESTON COUNTY,10736,6194
45021,4326,3772,SC,SOUTH CAROLINA,CHEROKEE COUNTY,5410,-1084
45023,3177,1221,SC,SOUTH CAROLINA,CHESTER COUNTY,1581,1596
45025,4067,2355,SC,SOUTH CAROLINA,CHESTERFIELD COUNTY,3208,859
45027,3576,1683,SC,SOUTH CAROLINA,CLARENDON COUNTY,2422,1154
45029,3960,1546,SC,SOUTH CAROLINA,COLLETON COUNTY,1900,2060
45031,6549,4943,SC,SOUTH CAROLINA,DARLINGTON COUNTY,7573,-1024
45033,3821,2925,SC,SOUTH CAROLINA,DILLON COUNTY,3893,-72
45035,6872,4379,SC,SOUTH CAROLINA,DORCHESTER COUNTY,6836,36
45037,1824,617,SC,SOUTH CAROLINA,EDGEFIELD COUNTY,1109,715
45039,2342,895,SC,SOUTH CAROLINA,FAIRFIELD COUNTY,1490,852
45041,11872,8571,SC,SOUTH CAROLINA,FLORENCE COUNTY,12886,-1014
45043,4277,3059,SC,SOUTH CAROLINA,GEORGETOWN COUNTY,4445,-168
45045,21665,16320,SC,SOUTH CAROLINA,GREENVILLE COUNTY,27199,-5534
45047,5184,2365,SC,SOUTH CAROLINA,GREENWOOD COUNTY,3548,1636
45049,2051,677,SC,SOUTH CAROLINA,HAMPTON COUNTY,1006,1045
45051,18029,11590,SC,SOUTH CAROLINA,HORRY COUNTY,17363,666
45053,2170,396,SC,SOUTH CAROLINA,JASPER COUNTY,993,1177
45055,4386,1760,SC,SOUTH CAROLINA,KERSHAW COUNTY,2742,1644
45057,5098,1967,SC,SOUTH CAROLINA,LANCASTER COUNTY,3142,1956
45059,4886,3675,SC,SOUTH CAROLINA,LAURENS COUNTY,5568,-682
45061,2186,1072,SC,SOUTH CAROLINA,LEE COUNTY,1586,600
45063,13764,8540,SC,SOUTH CAROLINA,LEXINGTON COUNTY,14622,-858
45065,724,180,SC,SOUTH CAROLINA,MCCORMICK COUNTY,399,325
45067,4055,2961,SC,SOUTH CAROLINA,MARION COUNTY,4057,-2
45069,3111,1574,SC,SOUTH CAROLINA,MARLBORO COUNTY,2393,718
45071,2658,1313,SC,SOUTH CAROLINA,NEWBERRY COUNTY,1956,702
45073,3895,1789,SC,SOUTH CAROLINA,OCONEE COUNTY,2890,1005
45075,9360,6359,SC,SOUTH CAROLINA,ORANGEBURG COUNTY,8936,424
45077,5095,3459,SC,SOUTH CAROLINA,PICKENS COUNTY,5938,-843
45079,24656,18183,SC,SOUTH CAROLINA,RICHLAND COUNTY,28681,-4025
45081,1334,534,SC,SOUTH CAROLINA,SALUDA COUNTY,919,415
45083,17515,13502,SC,SOUTH CAROLINA,SPARTANBURG COUNTY,21378,-3863
45085,9456,6729,SC,SOUTH CAROLINA,SUMTER COUNTY,10110,-654
45087,2660,1970,SC,SOUTH CAROLINA,UNION COUNTY,2869,-209
45089,4291,2207,SC,SOUTH CAROLINA,WILLIAMSBURG COUNTY,3407,884
45091,10422,4174,SC,SOUTH CAROLINA,YORK COUNTY,6213,4209
08,0,201,CO,COLORADO,**NOT AVAILABLE**,54,-54
24,0,339,MD,MARYLAND,**NOT AVAILABLE**,49,-49
26,0,241,MI,MICHIGAN,**NOT AVAILABLE**,83,-83
37,0,340,NC,NORTH CAROLINA,**NOT AVAILABLE**,147,-147
42,0,160,PA,PENNSYLVANIA,**NOT AVAILABLE**,86,-86
45,0,121,SC,SOUTH CAROLINA,**NOT AVAILABLE**,60,-60
